"中学校生徒数,学級数",一学年（人）,二学年（人）,三学年（人）,男（人）,女（人）,計（人）,生徒数（再掲）特別支援学級,学級数（学級）,（再掲）特別支援学級数
#N/A,120,120,118,158,200,358,,9,
岡山市北区足守中学校,46,45,41,68,64,132,6,7,2
岡山市北区岡輝中学校,88,78,99,139,126,265,17,11,3
岡山市北区中山中学校,187,181,209,271,306,577,12,20,3
岡山市北区石井中学校,139,126,128,221,172,393,13,14,2
岡山市北区高松中学校,184,150,159,246,247,493,8,16,2
岡山市北区建部中学校,40,28,33,61,40,101,5,5,2
岡山市北区御南中学校,291,305,292,505,383,888,19,30,4
岡山市北区京山中学校,270,315,297,463,419,882,29,30,5
岡山市北区岡北中学校,158,164,167,241,248,489,11,15,2
#N/A,77,71,72,87,133,220,,6,
岡山市北区吉備中学校,292,273,291,430,426,856,20,29,4
岡山市北区岡山中央中学校,139,102,109,160,190,350,21,15,5
岡山市北区桑田中学校,260,255,222,382,355,737,23,27,5
岡山市北区御津中学校,50,66,61,103,74,177,13,9,3
岡山市北区香和中学校,138,154,126,217,201,418,13,15,3
岡山市中区竜操中学校,321,316,340,464,513,977,29,33,5
岡山市中区操山中学校,201,197,203,319,282,601,36,24,6
岡山市中区高島中学校,159,154,190,257,246,503,15,17,3
#N/A,6,3,23,23,9,32,,3,
岡山市中区操南中学校,259,266,268,426,367,793,22,27,4
岡山市中区東山中学校,100,134,121,188,167,355,14,12,2
岡山市中区富山中学校,108,120,101,173,156,329,11,12,2
岡山市東区旭東中学校,306,276,319,469,432,901,34,32,6
岡山市東区上南中学校,51,36,59,74,72,146,4,7,2
岡山市東区山南中学校,69,62,81,110,102,212,4,8,2
岡山市東区西大寺中学校,183,165,186,284,250,534,14,18,2
岡山市東区瀬戸中学校,108,129,122,179,180,359,12,12,2
岡山市東区上道中学校,123,154,141,223,195,418,9,14,2
岡山市南区光南台中学校,42,48,59,75,74,149,6,8,2
岡山市南区妹尾中学校,100,102,98,173,127,300,10,11,2
岡山市南区福南中学校,138,145,152,210,225,435,11,14,2
岡山市南区芳泉中学校,321,324,327,487,485,972,33,33,6
岡山市南区芳田中学校,141,180,191,257,255,512,14,18,3
岡山市南区興除中学校,128,151,141,220,200,420,13,15,3
岡山市南区灘崎中学校,131,132,126,216,173,389,17,15,3
岡山市南区藤田中学校,119,116,122,193,164,357,14,13,3
岡山市南区福浜中学校,243,205,256,339,365,704,21,25,4
岡山市南区福田中学校,103,114,131,184,164,348,8,13,2
#N/A,120,120,119,185,174,359,,9,
倉敷市東中学校,233,247,233,378,335,713,22,26,5
倉敷市西中学校,316,297,300,452,461,913,25,32,5
倉敷市南中学校,349,336,386,559,512,"1,071",44,39,8
倉敷市北中学校,193,215,190,316,282,598,25,24,5
倉敷市多津美中学校,190,176,187,274,279,553,14,20,3
倉敷市新田中学校,202,253,234,352,337,689,9,23,2
倉敷市東陽中学校,264,236,245,387,358,745,17,25,3
倉敷市庄中学校,131,159,126,217,199,416,14,15,2
倉敷市倉敷第一中学校,257,265,298,441,379,820,18,28,3
岡山市南区福田中学校,191,200,220,301,310,611,18,22,3
倉敷市福田南中学校,152,166,157,240,235,475,17,18,3
倉敷市水島中学校,75,71,79,117,108,225,18,9,3
倉敷市連島中学校,193,187,189,287,282,569,18,22,4
倉敷市連島南中学校,108,106,107,153,168,321,10,12,2
倉敷市味野中学校,135,127,133,224,171,395,13,14,2
倉敷市下津井中学校,28,24,31,46,37,83,3,5,2
倉敷市児島中学校,155,161,191,282,225,507,23,20,4
倉敷市琴浦中学校,176,187,160,269,254,523,17,19,3
倉敷市郷内中学校,65,79,71,107,108,215,7,8,2
倉敷市玉島東中学校,169,176,179,242,282,524,17,18,3
倉敷市玉島西中学校,122,157,142,217,204,421,14,15,2
倉敷市玉島北中学校,197,224,194,314,301,615,10,21,2
倉敷市黒崎中学校,22,31,40,40,53,93,1,4,1
倉敷市船穂中学校,55,49,59,83,80,163,3,8,2
倉敷市真備東中学校,132,120,123,206,169,375,12,14,2
倉敷市真備中学校,76,86,71,115,118,233,3,8,1
#N/A,80,80,80,108,132,240,,6,
津山市津山東中学校,219,216,237,355,317,672,25,25,6
津山市中道中学校,129,137,153,214,205,419,22,17,4
津山市北陵中学校,218,223,196,341,296,637,22,22,3
津山市鶴山中学校,74,71,82,107,120,227,8,9,2
津山市津山西中学校,145,152,154,236,215,451,21,18,4
津山市加茂中学校,32,43,46,62,59,121,1,6,1
津山市勝北中学校,56,49,60,90,75,165,5,8,2
津山市久米中学校,52,53,54,73,86,159,10,8,2
玉野市宇野中学校,114,147,120,211,170,381,8,15,2
玉野市玉中学校,51,71,53,82,93,175,9,8,2
玉野市日比中学校,58,43,49,71,79,150,7,8,2
玉野市山田中学校,20,28,37,49,36,85,2,4,1
玉野市荘内中学校,85,101,118,170,134,304,12,12,2
玉野市八浜中学校,47,40,50,63,74,137,4,6,1
玉野市東児中学校,32,37,31,55,45,100,2,4,1
笠岡市笠岡東中学校,117,96,128,185,156,341,9,13,2
笠岡市笠岡西中学校,64,84,93,114,127,241,7,10,2
笠岡市金浦中学校,69,75,61,105,100,205,8,8,2
笠岡市新吉中学校,40,28,43,59,52,111,3,6,2
笠岡市大島中学校,28,18,22,30,38,68,1,4,1
笠岡市神島外中学校,5,6,2,10,3,13,,3,
笠岡市白石中学校,3,4,2,4,5,9,2,4,1
笠岡市北木中学校,3,2,1,5,1,6,,3,
笠岡市真鍋中学校,2,,,1,1,2,,1,
笠岡市小北中学校,30,39,47,59,57,116,9,6,2
井原市高屋中学校,65,52,72,104,85,189,3,8,2
井原市木之子中学校,55,63,64,89,93,182,12,10,4
井原市井原中学校,150,169,156,265,210,475,15,18,3
井原市芳井中学校,27,35,28,42,48,90,2,4,1
井原市美星中学校,26,34,26,46,40,86,1,4,1
総社市総社東中学校,275,278,290,445,398,843,27,29,5
総社市総社西中学校,236,260,282,403,375,778,27,27,4
総社市総社中学校,90,71,88,126,123,249,9,10,2
総社市昭和中学校,24,25,19,32,36,68,9,5,2
高梁市高梁中学校,114,93,118,168,157,325,5,13,2
高梁市高梁東中学校,20,10,24,21,33,54,,3,
高梁市高梁北中学校,13,12,21,25,21,46,2,4,1
高梁市有漢中学校,16,18,17,24,27,51,1,4,1
高梁市成羽中学校,38,54,47,74,65,139,11,8,3
高梁市川上中学校,18,20,19,31,26,57,3,5,2
新見市新見第一中学校,127,138,136,212,189,401,15,14,2
新見市新見南中学校,47,50,51,69,79,148,1,7,1
新見市大佐中学校,26,30,23,48,31,79,3,4,1
新見市哲多中学校,27,21,29,42,35,77,1,4,1
新見市哲西中学校,26,21,19,36,30,66,3,4,1
備前市備前中学校,106,104,110,173,147,320,21,13,4
備前市伊里中学校,36,49,42,68,59,127,1,6,1
備前市三石中学校,11,15,17,23,20,43,,3,
備前市日生中学校,61,60,75,94,102,196,6,8,2
備前市吉永中学校,45,42,30,70,47,117,7,6,2
瀬戸内市牛窓中学校,34,42,37,60,53,113,3,5,1
瀬戸内市邑久中学校,151,146,172,222,247,469,8,15,2
瀬戸内市長船中学校,128,115,125,182,186,368,16,14,3
赤磐市高陽中学校,95,106,125,169,157,326,22,13,4
赤磐市桜が丘中学校,180,181,201,275,287,562,14,20,3
赤磐市赤坂中学校,26,35,37,52,46,98,9,5,2
赤磐市磐梨中学校,59,64,46,96,73,169,9,8,2
赤磐市吉井中学校,17,28,37,41,41,82,3,5,2
真庭市北房中学校,40,48,43,69,62,131,4,6,1
真庭市落合中学校,119,104,95,162,156,318,5,12,2
真庭市久世中学校,94,106,113,140,173,313,6,12,2
真庭市勝山中学校,67,64,66,112,85,197,13,10,4
真庭市湯原中学校,17,11,20,25,23,48,1,4,1
真庭市蒜山中学校,41,36,52,69,60,129,2,6,1
美作市勝田中学校,24,10,14,25,23,48,5,5,2
美作市大原中学校,35,37,45,50,67,117,7,6,2
美作市美作中学校,83,113,99,153,142,295,13,11,2
美作市作東中学校,36,39,48,53,70,123,6,7,2
美作市英田中学校,18,18,14,20,30,50,8,5,2
浅口市金光中学校,90,87,80,138,119,257,9,10,2
浅口市鴨方中学校,144,153,141,222,216,438,6,16,2
浅口市寄島中学校,32,32,34,55,43,98,3,5,2
和気郡和気町佐伯中学校,20,17,19,31,25,56,1,4,1
和気郡和気町和気中学校,88,104,98,150,140,290,8,11,2
都窪郡早島町早島中学校,116,113,107,179,157,336,11,14,3
浅口郡里庄町里庄中学校,93,98,93,152,132,284,4,10,1
小田郡矢掛町矢掛中学校,77,113,100,176,114,290,19,12,4
真庭郡新庄村新庄中学校,5,6,10,11,10,21,,3,
苫田郡鏡野町鏡野中学校,108,92,121,159,162,321,13,14,3
勝田郡勝央町勝央中学校,91,106,100,150,147,297,12,11,2
勝田郡奈義町奈義中学校,54,55,42,79,72,151,6,8,2
英田郡西粟倉村西粟倉中学校,14,6,13,14,19,33,,3,
久米郡久米南町久米南中学校,34,38,45,58,59,117,5,6,2
久米郡美咲町中央中学校,69,54,55,96,82,178,9,8,2
久米郡美咲町旭中学校,18,15,14,27,20,47,3,4,1
久米郡美咲町柵原中学校,43,52,54,68,81,149,3,7,1
#N/A,87,85,80,137,115,252,15,10,3
